1111111111111111111
1000010000000000001
1111000110110101101
1000011000100001101
1111000011101100001
1000010110001001011
1101110000100011011
1000010111101010101
1011000010001010101
1001111010101000001
1010001000101011111
1001010010000010001
1011011011101000101
1000000000000010001
1111111111111111111
